country,price,start_year,end_year,n_obs,annual_growth_rate_pct
AUS,bitcoalINDUSTRY_atpr,1982,1989,7,-5.3299999
AUS,cokcoalINDUSTRY_atpr,1978,1989,11,-7.0300002
AUS,dieselHOUSEHOLDS_atp,1978,2016,38,.52999997
AUS,electrHOUSEHOLDS_atp,1978,2016,38,1.25
AUS,electrINDUSTRY_atpri,1978,2004,26,-.16
AUS,hsfoINDUSTRY_atprice,1978,1983,5,12.36
AUS,leadpremHOUSEHOLDS_a,1978,2003,25,-.85000002
AUS,lfoHOUSEHOLDS_atpric,1978,1983,5,11.85
AUS,lfoINDUSTRY_atprice,1978,1983,5,10.06
AUS,lpgHOUSEHOLDS_atpric,2006,2016,10,-3.5899999
AUS,unprem95HOUSEHOLDS_a,1992,2016,24,.94
AUS,unregHOUSEHOLDS_atpr,1991,2016,25,.43000001
AUS,dieselHOUSEHOLDS_pri,1978,2016,38,1.0700001
AUS,electrHOUSEHOLDS_pri,1978,2016,38,1.5
AUS,leadpremHOUSEHOLDS_p,1978,2003,25,.85000002
AUS,lfoHOUSEHOLDS_price,1978,1983,5,12.11
AUS,lpgHOUSEHOLDS_price,2006,2016,10,-1.02
AUS,natgasHOUSEHOLDS_pri,1978,1997,19,.19
AUS,unprem95HOUSEHOLDS_p,1992,2016,24,.63
AUS,unregHOUSEHOLDS_pric,1991,2016,25,.15000001
AUS,bitcoalINDUSTRY_pric,1982,1989,7,-5.3299999
AUS,cokcoalINDUSTRY_pric,1978,1989,11,-7.0300002
AUS,dieselINDUSTRY_price,1978,1995,17,-2.25
AUS,electrINDUSTRY_price,1978,2004,26,-.16
AUS,hsfoINDUSTRY_price,1978,1983,5,12.78
AUS,lfoINDUSTRY_price,1978,1983,5,14.28
AUS,natgasINDUSTRY_price,1978,1997,19,2.0899999
AUT,bitcoalHOUSEHOLDS_at,1978,2005,27,-1.0700001
AUT,bitcoalINDUSTRY_atpr,1978,2016,38,-2.24
AUT,dieselHOUSEHOLDS_atp,1978,2016,38,-.73000002
AUT,dieselINDUSTRY_atpri,1978,2016,38,-1.71
AUT,electrHOUSEHOLDS_atp,1978,2016,38,-1.23
AUT,electrINDUSTRY_atpri,1978,2016,38,-1.25
AUT,hsfoINDUSTRY_atprice,1978,1998,20,-6.6999998
AUT,leadpremHOUSEHOLDS_a,1978,1992,14,-1.39
AUT,lfoHOUSEHOLDS_atpric,1981,2016,35,-1.34
AUT,lfoINDUSTRY_atprice,1980,2016,36,-1.35
AUT,lsfoINDUSTRY_atprice,1995,2016,21,1.63
AUT,natgasHOUSEHOLDS_atp,1979,2016,37,-.98000002
AUT,natgasINDUSTRY_atpri,1978,2016,38,.51999998
AUT,unprem95HOUSEHOLDS_a,1987,2016,29,-.60000002
AUT,unprem98HOUSEHOLDS_a,1993,2016,23,.31999999
AUT,unregHOUSEHOLDS_atpr,1986,2016,30,-.20999999
AUT,bitcoalHOUSEHOLDS_pr,1978,2005,27,-.079999998
AUT,dieselHOUSEHOLDS_pri,1978,2016,38,-.22
AUT,electrHOUSEHOLDS_pri,1978,2016,38,-.15000001
AUT,leadpremHOUSEHOLDS_p,1978,1992,14,.5
AUT,lfoHOUSEHOLDS_price,1978,2016,38,-.25
AUT,natgasHOUSEHOLDS_pri,1979,2016,37,-.34
AUT,unprem95HOUSEHOLDS_p,1987,2016,29,-.23999999
AUT,unprem98HOUSEHOLDS_p,1993,2016,23,.050000001
AUT,unregHOUSEHOLDS_pric,1986,2016,30,.23999999
AUT,bitcoalINDUSTRY_pric,1978,2016,38,-1.1900001
AUT,dieselINDUSTRY_price,1978,2016,38,-.97000003
AUT,electrINDUSTRY_price,1978,2016,38,-.25999999
AUT,hsfoINDUSTRY_price,1978,1998,20,-3.76
AUT,lfoINDUSTRY_price,1980,2016,36,-1.08
AUT,lsfoINDUSTRY_price,1995,2016,21,1.01
AUT,natgasINDUSTRY_price,1978,2016,38,1.24
BEL,bitcoalHOUSEHOLDS_at,1978,2013,35,1.1900001
BEL,bitcoalINDUSTRY_atpr,1978,1991,13,-.38999999
BEL,cokcoalINDUSTRY_atpr,1978,2001,23,-4.1100001
BEL,dieselHOUSEHOLDS_atp,1990,2016,26,.57999998
BEL,dieselINDUSTRY_atpri,1978,2016,38,1.26
BEL,electrHOUSEHOLDS_atp,1978,2016,38,-1.22
BEL,electrINDUSTRY_atpri,1978,2016,38,-.94
BEL,hsfoINDUSTRY_atprice,1978,2002,24,-1.45
BEL,leadpremHOUSEHOLDS_a,1978,2002,24,-1.24
BEL,lfoHOUSEHOLDS_atpric,1978,2016,38,.15000001
BEL,lfoINDUSTRY_atprice,1978,2016,38,.15000001
BEL,lpgHOUSEHOLDS_atpric,2000,2016,16,-.5
BEL,lpgINDUSTRY_atprice,2002,2016,14,.41
BEL,lsfoINDUSTRY_atprice,1989,2016,27,.56999999
BEL,natgasHOUSEHOLDS_atp,1978,2016,38,-.51999998
BEL,natgasINDUSTRY_atpri,1978,2016,38,.23999999
BEL,unprem95HOUSEHOLDS_a,1990,2016,26,.14
BEL,unprem98HOUSEHOLDS_a,1990,2016,26,.079999998
BEL,bitcoalHOUSEHOLDS_pr,1978,2013,35,1.35
BEL,dieselHOUSEHOLDS_pri,1990,2016,26,.63
BEL,electrHOUSEHOLDS_pri,1978,2016,38,-.43000001
BEL,leadpremHOUSEHOLDS_p,1978,2002,24,-.60000002
BEL,lfoHOUSEHOLDS_price,1978,2016,38,.36000001
BEL,lpgHOUSEHOLDS_price,2000,2016,16,-.49000001
BEL,natgasHOUSEHOLDS_pri,1978,2016,38,.029999999
BEL,unprem95HOUSEHOLDS_p,1990,2016,26,.15000001
BEL,unprem98HOUSEHOLDS_p,1990,2016,26,.11
BEL,bitcoalINDUSTRY_pric,1978,1991,13,-.38999999
BEL,cokcoalINDUSTRY_pric,1978,2001,23,-4.1100001
BEL,dieselINDUSTRY_price,1978,2016,38,.99000001
BEL,electrINDUSTRY_price,1978,2016,38,-.41999999
BEL,hsfoINDUSTRY_price,1978,2002,24,-1.12
BEL,lfoINDUSTRY_price,1978,2016,38,.0099999998
BEL,lpgINDUSTRY_price,2002,2016,14,.41
BEL,lsfoINDUSTRY_price,1989,2016,27,.82999998
BEL,natgasINDUSTRY_price,1978,2016,38,.38
BRA,electrHOUSEHOLDS_pri,1988,1998,10,.25999999
BRA,unprem95HOUSEHOLDS_p,1988,1998,10,-.63
BRA,unregHOUSEHOLDS_pric,1988,1998,10,-5.3499999
BRA,bitcoalINDUSTRY_pric,1988,1998,10,-3.8900001
BRA,dieselINDUSTRY_price,1988,1998,10,-6.0999999
BRA,electrINDUSTRY_price,1988,1998,10,-5.27
BRA,hsfoINDUSTRY_price,1988,1998,10,-6.5300002
BRA,natgasINDUSTRY_price,1988,1998,10,-9.7700005
CAN,dieselHOUSEHOLDS_atp,1984,2016,32,-.16
CAN,dieselINDUSTRY_atpri,2000,2016,16,1.3
CAN,electrHOUSEHOLDS_atp,1990,2016,26,.40000001
CAN,electrINDUSTRY_atpri,1990,2016,26,.57999998
CAN,hsfoINDUSTRY_atprice,1991,2016,25,1.1799999
CAN,lfoHOUSEHOLDS_atpric,1991,2016,25,.97000003
CAN,lfoINDUSTRY_atprice,1991,2016,25,1.14
CAN,lpgHOUSEHOLDS_atpric,2000,2016,16,.62
CAN,natgasHOUSEHOLDS_atp,2004,2016,12,-2.8699999
CAN,natgasINDUSTRY_atpri,2004,2016,12,-4.3699999
CAN,unprem95HOUSEHOLDS_a,1980,2016,36,-.20999999
CAN,unprem98HOUSEHOLDS_a,1990,2016,26,.43000001
CAN,unregHOUSEHOLDS_atpr,1978,2016,38,.61000001
CAN,dieselHOUSEHOLDS_pri,1978,2016,38,-.79000002
CAN,electrHOUSEHOLDS_pri,1978,2016,38,1.05
CAN,lfoHOUSEHOLDS_price,1978,2016,38,2.1400001
CAN,lpgHOUSEHOLDS_price,2000,2016,16,.61000001
CAN,natgasHOUSEHOLDS_pri,1978,2016,38,.22
CAN,unprem95HOUSEHOLDS_p,1980,2016,36,-.059999999
CAN,unprem98HOUSEHOLDS_p,1990,2016,26,.050000001
CAN,unregHOUSEHOLDS_pric,1978,2016,38,.92000002
CAN,bitcoalINDUSTRY_pric,1978,1989,11,-2.1300001
CAN,cokcoalINDUSTRY_pric,1978,1989,11,-5.8099999
CAN,dieselINDUSTRY_price,2000,2016,16,.98000002
CAN,electrINDUSTRY_price,1978,2016,38,1.47
CAN,hsfoINDUSTRY_price,1978,2016,38,.51999998
CAN,lfoINDUSTRY_price,1978,2016,38,1.37
CAN,natgasINDUSTRY_price,1978,2016,38,-.07
CHE,bitcoalHOUSEHOLDS_at,1978,1992,14,1.64
CHE,bitcoalINDUSTRY_atpr,1978,2016,38,-1.71
CHE,cokcoalINDUSTRY_atpr,1979,1988,9,-3.02
CHE,dieselHOUSEHOLDS_atp,1979,2016,37,-1.22
CHE,dieselINDUSTRY_atpri,1994,2016,22,.73000002
CHE,electrHOUSEHOLDS_atp,1978,2016,38,-.28999999
CHE,electrINDUSTRY_atpri,1978,2016,38,-.61000001
CHE,hsfoINDUSTRY_atprice,1978,1990,12,-2.1800001
CHE,leadpremHOUSEHOLDS_a,1978,1999,21,-2.2
CHE,lfoHOUSEHOLDS_atpric,1978,2016,38,.079999998
CHE,lfoINDUSTRY_atprice,1978,2016,38,.029999999
CHE,lsfoINDUSTRY_atprice,1991,2013,22,6.0500002
CHE,natgasHOUSEHOLDS_atp,1978,2016,38,0
CHE,natgasINDUSTRY_atpri,1978,2016,38,-.22
CHE,unprem95HOUSEHOLDS_a,1986,2016,30,.69
CHE,unprem98HOUSEHOLDS_a,1994,2016,22,1.63
CHE,bitcoalHOUSEHOLDS_pr,1978,1992,14,1.84
CHE,dieselHOUSEHOLDS_pri,1978,2016,38,-.64999998
CHE,electrHOUSEHOLDS_pri,1978,2016,38,.1
CHE,leadpremHOUSEHOLDS_p,1978,1999,21,-1.14
CHE,lfoHOUSEHOLDS_price,1978,2016,38,1.25
CHE,natgasHOUSEHOLDS_pri,1978,2016,38,.69999999
CHE,unprem95HOUSEHOLDS_p,1986,2016,30,1.11
CHE,unprem98HOUSEHOLDS_p,1994,2016,22,.56
CHE,bitcoalINDUSTRY_pric,1978,2016,38,-1.71
CHE,cokcoalINDUSTRY_pric,1979,1988,9,-1.95
CHE,dieselINDUSTRY_price,1994,2016,22,0
CHE,electrINDUSTRY_price,1978,2016,38,-.34
CHE,hsfoINDUSTRY_price,1978,1990,12,-1.6900001
CHE,lfoINDUSTRY_price,1978,2016,38,1.08
CHE,lsfoINDUSTRY_price,1991,2013,22,6.02
CHE,natgasINDUSTRY_price,1978,2016,38,.54000002
CHL,cokcoalINDUSTRY_atpr,2002,2016,14,1.99
CHL,dieselHOUSEHOLDS_atp,2000,2016,16,.72000003
CHL,electrHOUSEHOLDS_atp,2000,2016,16,2.3199999
CHL,electrINDUSTRY_atpri,2000,2016,16,4.1799998
CHL,lfoHOUSEHOLDS_atpric,2000,2016,16,2.9300001
CHL,natgasHOUSEHOLDS_atp,2000,2016,16,1.67
CHL,unprem95HOUSEHOLDS_a,2000,2016,16,1.11
CHL,unprem98HOUSEHOLDS_a,2000,2016,16,1.36
CHL,unregHOUSEHOLDS_atpr,2000,2016,16,.91000003
CHL,dieselHOUSEHOLDS_pri,1994,2016,22,1.35
CHL,electrHOUSEHOLDS_pri,1983,2016,33,2.6099999
CHL,lfoHOUSEHOLDS_price,1994,2016,22,3.27
CHL,natgasHOUSEHOLDS_pri,2000,2016,16,1.73
CHL,unprem95HOUSEHOLDS_p,1995,2016,21,1.73
CHL,unprem98HOUSEHOLDS_p,1995,2016,21,1.92
CHL,unregHOUSEHOLDS_pric,1994,2016,22,2.02
CHL,cokcoalINDUSTRY_pric,2002,2016,14,1.99
CHL,electrINDUSTRY_price,2000,2016,16,4.1799998
CHN,bitcoalHOUSEHOLDS_pr,1992,2002,10,-.75
CHN,dieselHOUSEHOLDS_pri,2001,2010,9,10.78
CHN,leadpremHOUSEHOLDS_p,1994,2002,8,2.9100001
CHN,unregHOUSEHOLDS_pric,2001,2010,9,10.79
CHN,bitcoalINDUSTRY_pric,1992,2004,12,-4.6900001
CHN,cokcoalINDUSTRY_pric,1994,2005,11,.76999998
CHN,dieselINDUSTRY_price,1994,2010,16,6.8299999
CHN,electrINDUSTRY_price,1990,1996,6,2.01
CYP,dieselHOUSEHOLDS_atp,2005,2011,6,7.7800002
CYP,dieselINDUSTRY_atpri,2005,2011,6,7.7800002
CYP,lfoHOUSEHOLDS_atpric,2005,2011,6,8.4200001
CYP,lfoINDUSTRY_atprice,2005,2011,6,8.4200001
CYP,unprem95HOUSEHOLDS_a,2005,2011,6,7.6399999
CYP,dieselHOUSEHOLDS_pri,2005,2011,6,7.0500002
CYP,leadpremHOUSEHOLDS_p,1978,2004,26,-.19
CYP,leadregHOUSEHOLDS_pr,1978,2002,24,-.88999999
CYP,lfoHOUSEHOLDS_price,2005,2011,6,5.21
CYP,lpgHOUSEHOLDS_price,1978,2006,28,2.1099999
CYP,unprem95HOUSEHOLDS_p,1992,2011,19,2.6199999
CYP,unprem98HOUSEHOLDS_p,2000,2006,6,6.6399999
CYP,dieselINDUSTRY_price,2005,2011,6,7.04
CYP,electrINDUSTRY_price,1978,2010,32,1.14
CYP,lfoINDUSTRY_price,2005,2011,6,5.21
CZE,bitcoalHOUSEHOLDS_at,1978,2016,38,4.02
CZE,bitcoalINDUSTRY_atpr,1985,2002,17,1.0599999
CZE,cokcoalINDUSTRY_atpr,1985,2002,17,-.0099999998
CZE,dieselHOUSEHOLDS_atp,1985,2016,31,1.5599999
CZE,dieselINDUSTRY_atpri,1978,2016,38,2.53
CZE,electrHOUSEHOLDS_atp,1978,2016,38,.60000002
CZE,electrINDUSTRY_atpri,1985,2016,31,1.71
CZE,hsfoINDUSTRY_atprice,1978,2008,30,2.6600001
CZE,leadpremHOUSEHOLDS_a,1978,2000,22,4.3600001
CZE,leadregHOUSEHOLDS_at,1985,2000,15,2.3699999
CZE,lfoHOUSEHOLDS_atpric,1993,2016,23,1.75
CZE,lfoINDUSTRY_atprice,1978,2016,38,2.1300001
CZE,lpgHOUSEHOLDS_atpric,2002,2016,14,.69
CZE,lpgINDUSTRY_atprice,2002,2016,14,.68000001
CZE,lsfoINDUSTRY_atprice,2001,2016,15,1.86
CZE,natgasHOUSEHOLDS_atp,1978,2016,38,2.9000001
CZE,natgasINDUSTRY_atpri,1985,2016,31,-.02
CZE,unprem95HOUSEHOLDS_a,1989,2016,27,1.46
CZE,unprem98HOUSEHOLDS_a,1990,2016,26,1.42
CZE,unregHOUSEHOLDS_atpr,2001,2013,12,6.9400001
CZE,bitcoalHOUSEHOLDS_pr,1978,2016,38,4.6799998
CZE,dieselHOUSEHOLDS_pri,1985,2016,31,1.9
CZE,electrHOUSEHOLDS_pri,1978,2016,38,1.13
CZE,leadpremHOUSEHOLDS_p,1978,2000,22,-1.12
CZE,leadregHOUSEHOLDS_pr,1985,2000,15,.63
CZE,lfoHOUSEHOLDS_price,1987,2016,29,6.5300002
CZE,lpgHOUSEHOLDS_price,2002,2016,14,.97000003
CZE,natgasHOUSEHOLDS_pri,1978,2016,38,3.8499999
CZE,unprem95HOUSEHOLDS_p,1989,2016,27,.46000001
CZE,unprem98HOUSEHOLDS_p,1990,2016,26,.41999999
CZE,unregHOUSEHOLDS_pric,2001,2013,12,5.98
CZE,bitcoalINDUSTRY_pric,1985,2002,17,1.0599999
CZE,cokcoalINDUSTRY_pric,1985,2002,17,-.0099999998
CZE,dieselINDUSTRY_price,1978,2016,38,2.1600001
CZE,electrINDUSTRY_price,1985,2016,31,1.75
CZE,hsfoINDUSTRY_price,1978,2008,30,2.8800001
CZE,lfoINDUSTRY_price,1978,2016,38,2.3
CZE,lpgINDUSTRY_price,2002,2016,14,1.02
CZE,lsfoINDUSTRY_price,2001,2016,15,2.4200001
CZE,natgasINDUSTRY_price,1985,2016,31,.12
DEU,bitcoalHOUSEHOLDS_at,1978,1994,16,.13
DEU,bitcoalINDUSTRY_atpr,1978,1994,16,.22
DEU,cokcoalINDUSTRY_atpr,1978,1998,20,-4.1799998
DEU,dieselHOUSEHOLDS_atp,1978,2016,38,-.2
DEU,dieselINDUSTRY_atpri,1978,2016,38,-.2
DEU,electrHOUSEHOLDS_atp,1978,2016,38,-.88999999
DEU,electrINDUSTRY_atpri,1978,2016,38,-1.46
DEU,hsfoINDUSTRY_atprice,1978,1990,12,-2.5999999
DEU,leadpremHOUSEHOLDS_a,1978,1996,18,-1.54
DEU,lfoHOUSEHOLDS_atpric,1978,2016,38,.02
DEU,lfoINDUSTRY_atprice,1978,2016,38,-.20999999
DEU,lpgHOUSEHOLDS_atpric,2005,2016,11,-3.71
DEU,lpgINDUSTRY_atprice,2005,2016,11,-3.6600001
DEU,lsfoINDUSTRY_atprice,1991,2016,25,.68000001
DEU,natgasHOUSEHOLDS_atp,1978,2016,38,.059999999
DEU,natgasINDUSTRY_atpri,1978,2016,38,-.23999999
DEU,unprem95HOUSEHOLDS_a,1986,2016,30,.57999998
DEU,unprem98HOUSEHOLDS_a,1993,2016,23,1.35
DEU,unregHOUSEHOLDS_atpr,1986,2010,24,3.24
DEU,bitcoalHOUSEHOLDS_pr,1978,1994,16,.30000001
DEU,dieselHOUSEHOLDS_pri,1978,2016,38,-.16
DEU,electrHOUSEHOLDS_pri,1978,2016,38,.69999999
DEU,leadpremHOUSEHOLDS_p,1978,1996,18,1.22
DEU,lfoHOUSEHOLDS_price,1978,2016,38,.49000001
DEU,lpgHOUSEHOLDS_price,2005,2016,11,-3.29
DEU,natgasHOUSEHOLDS_pri,1978,2016,38,.49000001
DEU,unprem95HOUSEHOLDS_p,1986,2016,30,1.48
DEU,unprem98HOUSEHOLDS_p,1993,2016,23,.51999998
DEU,unregHOUSEHOLDS_pric,1986,2010,24,3.6400001
DEU,bitcoalINDUSTRY_pric,1978,1994,16,.22
DEU,cokcoalINDUSTRY_pric,1978,1998,20,-4.1799998
DEU,dieselINDUSTRY_price,1978,2016,38,-.31999999
DEU,electrINDUSTRY_price,1978,2016,38,.050000001
DEU,hsfoINDUSTRY_price,1978,1990,12,-2.0799999
DEU,lfoINDUSTRY_price,1978,2016,38,.13
DEU,lpgINDUSTRY_price,2005,2016,11,-3.47
DEU,lsfoINDUSTRY_price,1991,2016,25,.57999998
DEU,natgasINDUSTRY_price,1978,2016,38,.19
DNK,bitcoalHOUSEHOLDS_at,1979,2002,23,-1.65
DNK,bitcoalINDUSTRY_atpr,1978,1995,17,-5.0599999
DNK,dieselHOUSEHOLDS_atp,1996,2016,20,1.5599999
DNK,dieselINDUSTRY_atpri,1978,2016,38,.36000001
DNK,electrHOUSEHOLDS_atp,1979,2015,36,-.14
DNK,electrINDUSTRY_atpri,1979,2015,36,-1.01
DNK,hsfoINDUSTRY_atprice,1978,1988,10,-2.9100001
DNK,leadpremHOUSEHOLDS_a,1978,1995,17,-1.09
DNK,lfoHOUSEHOLDS_atpric,1978,2016,38,1.04
DNK,lfoINDUSTRY_atprice,1978,2016,38,1
DNK,lsfoINDUSTRY_atprice,1989,2016,27,.55000001
DNK,natgasHOUSEHOLDS_atp,1984,2015,31,-.95999998
DNK,unprem95HOUSEHOLDS_a,1996,2016,20,.81999999
DNK,unprem98HOUSEHOLDS_a,1990,2013,23,2.72
DNK,unregHOUSEHOLDS_atpr,1990,2016,26,.28
DNK,bitcoalHOUSEHOLDS_pr,1979,2002,23,2.25
DNK,dieselHOUSEHOLDS_pri,1996,2016,20,.33000001
DNK,electrHOUSEHOLDS_pri,1978,2015,37,1.4400001
DNK,leadpremHOUSEHOLDS_p,1978,1995,17,.46000001
DNK,lfoHOUSEHOLDS_price,1978,2016,38,2.1400001
DNK,natgasHOUSEHOLDS_pri,1978,2015,37,-.87
DNK,unprem95HOUSEHOLDS_p,1996,2016,20,-.2
DNK,unprem98HOUSEHOLDS_p,1990,2013,23,1.87
DNK,unregHOUSEHOLDS_pric,1990,2016,26,.16
DNK,bitcoalINDUSTRY_pric,1978,1995,17,-3.4000001
DNK,dieselINDUSTRY_price,1978,2016,38,1.96
DNK,electrINDUSTRY_price,1978,2015,37,-1.38
DNK,hsfoINDUSTRY_price,1978,1988,10,-2.9100001
DNK,lfoINDUSTRY_price,1978,2016,38,1.3099999
DNK,lsfoINDUSTRY_price,1989,2016,27,1.8200001
ESP,cokcoalINDUSTRY_atpr,1978,1985,7,-6.8699999
ESP,dieselHOUSEHOLDS_atp,1978,2016,38,-.059999999
ESP,dieselINDUSTRY_atpri,1978,2016,38,-.059999999
ESP,electrHOUSEHOLDS_atp,1979,2016,37,.5
ESP,electrINDUSTRY_atpri,1979,2016,37,.75999999
ESP,hsfoINDUSTRY_atprice,1978,2003,25,.25
ESP,leadpremHOUSEHOLDS_a,1978,2006,28,-1.22
ESP,lfoHOUSEHOLDS_atpric,1978,2016,38,1.36
ESP,lfoINDUSTRY_atprice,1978,2016,38,1.36
ESP,lpgHOUSEHOLDS_atpric,2000,2016,16,1.45
ESP,lpgINDUSTRY_atprice,2000,2016,16,1.45
ESP,lsfoINDUSTRY_atprice,1995,2016,21,1.02
ESP,natgasHOUSEHOLDS_atp,1978,2016,38,.56
ESP,natgasINDUSTRY_atpri,1978,2016,38,-.63
ESP,unprem95HOUSEHOLDS_a,1992,2016,24,.33000001
ESP,dieselHOUSEHOLDS_pri,1978,2016,38,1.48
ESP,electrHOUSEHOLDS_pri,1978,2016,38,1.22
ESP,leadpremHOUSEHOLDS_p,1978,2006,28,.5
ESP,lfoHOUSEHOLDS_price,1978,2016,38,2.4400001
ESP,lpgHOUSEHOLDS_price,2000,2016,16,1.54
ESP,natgasHOUSEHOLDS_pri,1978,2016,38,1.16
ESP,unprem95HOUSEHOLDS_p,1992,2016,24,-.55000001
ESP,cokcoalINDUSTRY_pric,1978,1985,7,-6.8699999
ESP,dieselINDUSTRY_price,1978,2016,38,.98000002
ESP,electrINDUSTRY_price,1978,2016,38,.88999999
ESP,hsfoINDUSTRY_price,1978,2003,25,.51999998
ESP,lfoINDUSTRY_price,1978,2016,38,1.92
ESP,lpgINDUSTRY_price,2000,2016,16,1.28
ESP,lsfoINDUSTRY_price,1995,2016,21,.83999997
ESP,natgasINDUSTRY_price,1978,2016,38,-.56999999
EST,dieselHOUSEHOLDS_atp,2005,2016,11,-2.0999999
EST,dieselINDUSTRY_atpri,2005,2016,11,-2.0999999
EST,electrHOUSEHOLDS_atp,2008,2016,8,-.31999999
EST,electrINDUSTRY_atpri,2008,2016,8,-.34999999
EST,lfoHOUSEHOLDS_atpric,2005,2016,11,-1.97
EST,lfoINDUSTRY_atprice,2005,2016,11,-1.97
EST,lpgHOUSEHOLDS_atpric,2005,2016,11,-2.01
EST,lpgINDUSTRY_atprice,2005,2016,11,-2.01
EST,natgasHOUSEHOLDS_atp,2008,2016,8,-6.8699999
EST,natgasINDUSTRY_atpri,2008,2016,8,-7.3899999
EST,unprem95HOUSEHOLDS_a,2005,2016,11,-1.23
EST,dieselHOUSEHOLDS_pri,2005,2016,11,-.5
EST,electrHOUSEHOLDS_pri,2008,2016,8,-.090000004
EST,lfoHOUSEHOLDS_price,2005,2016,11,-.68000001
EST,lpgHOUSEHOLDS_price,2005,2016,11,-1.67
EST,natgasHOUSEHOLDS_pri,2008,2016,8,-5.9099998
EST,unprem95HOUSEHOLDS_p,2005,2016,11,-.20999999
EST,dieselINDUSTRY_price,2005,2016,11,-.64999998
EST,electrINDUSTRY_price,2008,2016,8,.69
EST,lfoINDUSTRY_price,2005,2016,11,-.82999998
EST,lpgINDUSTRY_price,2005,2016,11,-1.8200001
EST,natgasINDUSTRY_price,2008,2016,8,-6.21
FIN,bitcoalINDUSTRY_atpr,1978,2016,38,-1.5
FIN,cokcoalINDUSTRY_atpr,1995,2016,21,.63
FIN,dieselHOUSEHOLDS_atp,1978,2016,38,-.029999999
FIN,dieselINDUSTRY_atpri,1978,2016,38,-.029999999
FIN,electrHOUSEHOLDS_atp,1978,2016,38,-.97000003
FIN,electrINDUSTRY_atpri,1978,2016,38,-1.4400001
FIN,hsfoINDUSTRY_atprice,1978,1992,14,-1.97
FIN,leadpremHOUSEHOLDS_a,1978,1993,15,-4.1500001
FIN,lfoHOUSEHOLDS_atpric,1978,2016,38,.19
FIN,lfoINDUSTRY_atprice,1978,2016,38,.19
FIN,lsfoINDUSTRY_atprice,1993,2010,17,6.8000002
FIN,natgasHOUSEHOLDS_atp,1978,2000,22,-2.9000001
FIN,natgasINDUSTRY_atpri,1978,2016,38,-.34
FIN,unprem95HOUSEHOLDS_a,1990,2016,26,-2.1099999
FIN,unprem98HOUSEHOLDS_a,1994,2016,22,1.1900001
FIN,dieselHOUSEHOLDS_pri,1978,2016,38,1.02
FIN,electrHOUSEHOLDS_pri,1978,2016,38,-.02
FIN,leadpremHOUSEHOLDS_p,1978,1993,15,0
FIN,lfoHOUSEHOLDS_price,1978,2016,38,1.85
FIN,natgasHOUSEHOLDS_pri,1978,2000,22,-1.4400001
FIN,unprem95HOUSEHOLDS_p,1990,2016,26,-.38999999
FIN,unprem98HOUSEHOLDS_p,1994,2016,22,.74000001
FIN,bitcoalINDUSTRY_pric,1978,2016,38,1.87
FIN,cokcoalINDUSTRY_pric,1995,2016,21,3.75
FIN,dieselINDUSTRY_price,1978,2016,38,.44999999
FIN,electrINDUSTRY_price,1978,2016,38,-1.33
FIN,hsfoINDUSTRY_price,1978,1992,14,-1.71
FIN,lfoINDUSTRY_price,1978,2016,38,1.27
FIN,lsfoINDUSTRY_price,1993,2010,17,7.0300002
FIN,natgasINDUSTRY_price,1978,2016,38,1.15
FRA,bitcoalHOUSEHOLDS_at,1978,2002,24,-2.25
FRA,bitcoalINDUSTRY_atpr,1978,2003,25,-.34999999
FRA,cokcoalINDUSTRY_atpr,1978,2011,33,2.05
FRA,dieselHOUSEHOLDS_atp,1978,2016,38,-.07
FRA,dieselINDUSTRY_atpri,1978,2016,38,-.039999999
FRA,electrHOUSEHOLDS_atp,1978,2016,38,-1.3099999
FRA,electrINDUSTRY_atpri,1978,2016,38,-.41
FRA,hsfoINDUSTRY_atprice,1978,2009,31,1.6
FRA,leadpremHOUSEHOLDS_a,1978,2006,28,.60000002
FRA,lfoHOUSEHOLDS_atpric,1978,2016,38,.31
FRA,lfoINDUSTRY_atprice,1978,2016,38,.28
FRA,lpgHOUSEHOLDS_atpric,2000,2016,16,1.1799999
FRA,lpgINDUSTRY_atprice,2000,2016,16,1.1799999
FRA,lsfoINDUSTRY_atprice,1993,2016,23,4.04
FRA,natgasHOUSEHOLDS_atp,1978,2016,38,-.12
FRA,natgasINDUSTRY_atpri,1978,2016,38,.68000001
FRA,unprem95HOUSEHOLDS_a,1990,2016,26,.43000001
FRA,unprem98HOUSEHOLDS_a,1990,2016,26,.44
FRA,bitcoalHOUSEHOLDS_pr,1978,2002,24,-2.1800001
FRA,dieselHOUSEHOLDS_pri,1978,2016,38,.07
FRA,electrHOUSEHOLDS_pri,1978,2016,38,-.69999999
FRA,leadpremHOUSEHOLDS_p,1978,2006,28,.63999999
FRA,lfoHOUSEHOLDS_price,1978,2016,38,.62
FRA,lpgHOUSEHOLDS_price,2000,2016,16,1.14
FRA,natgasHOUSEHOLDS_pri,1978,2016,38,.13
FRA,unprem95HOUSEHOLDS_p,1990,2016,26,-.38999999
FRA,unprem98HOUSEHOLDS_p,1990,2016,26,-.34999999
FRA,bitcoalINDUSTRY_pric,1978,2003,25,-.34999999
FRA,cokcoalINDUSTRY_pric,1978,2011,33,2.05
FRA,dieselINDUSTRY_price,1978,2016,38,.02
FRA,electrINDUSTRY_price,1978,2016,38,.30000001
FRA,hsfoINDUSTRY_price,1978,2009,31,1.79
FRA,lfoINDUSTRY_price,1978,2016,38,.30000001
FRA,lpgINDUSTRY_price,2000,2016,16,1.14
FRA,lsfoINDUSTRY_price,1993,2016,23,3.78
FRA,natgasINDUSTRY_price,1978,2016,38,.99000001
GBR,bitcoalHOUSEHOLDS_at,1978,2016,38,1.5599999
GBR,bitcoalINDUSTRY_atpr,1978,2016,38,-.91000003
GBR,dieselHOUSEHOLDS_atp,1978,2016,38,-.41
GBR,dieselINDUSTRY_atpri,1978,2016,38,-.41
GBR,electrHOUSEHOLDS_atp,1978,2016,38,.64999998
GBR,electrINDUSTRY_atpri,1978,2016,38,.18000001
GBR,hsfoINDUSTRY_atprice,1978,2002,24,-1.03
GBR,leadpremHOUSEHOLDS_a,1978,2004,26,.63999999
GBR,lfoHOUSEHOLDS_atpric,1978,2016,38,-.31
GBR,lfoINDUSTRY_atprice,1978,2016,38,.37
GBR,lsfoINDUSTRY_atprice,2003,2007,4,17.360001
GBR,natgasHOUSEHOLDS_atp,1978,2016,38,1.37
GBR,natgasINDUSTRY_atpri,1978,2016,38,.20999999
GBR,unprem95HOUSEHOLDS_a,1990,2016,26,-.61000001
GBR,unprem98HOUSEHOLDS_a,1991,2016,25,.079999998
GBR,bitcoalHOUSEHOLDS_pr,1978,2016,38,1.7
GBR,dieselHOUSEHOLDS_pri,1978,2016,38,.81999999
GBR,electrHOUSEHOLDS_pri,1978,2016,38,.77999997
GBR,leadpremHOUSEHOLDS_p,1978,2004,26,2.78
GBR,lfoHOUSEHOLDS_price,1978,2016,38,.47999999
GBR,natgasHOUSEHOLDS_pri,1978,2016,38,1.5
GBR,unprem95HOUSEHOLDS_p,1990,2016,26,.63999999
GBR,unprem98HOUSEHOLDS_p,1991,2016,25,.67000002
GBR,bitcoalINDUSTRY_pric,1978,2016,38,-.72000003
GBR,dieselINDUSTRY_price,1978,2016,38,.63999999
GBR,electrINDUSTRY_price,1978,2016,38,.28
GBR,hsfoINDUSTRY_price,1978,2002,24,-.55000001
GBR,lfoINDUSTRY_price,1978,2016,38,.99000001
GBR,lsfoINDUSTRY_price,2003,2007,4,19.18
GBR,natgasINDUSTRY_price,1978,2016,38,.30000001
GHA,dieselHOUSEHOLDS_atp,1989,2011,22,5.9099998
GHA,hsfoINDUSTRY_atprice,1989,2011,22,5.71
GHA,lfoHOUSEHOLDS_atpric,1989,2011,22,5.6100001
GHA,lpgHOUSEHOLDS_atpric,1989,2011,22,3.25
GHA,unprem95HOUSEHOLDS_a,1989,2011,22,5.4400001
GHA,dieselHOUSEHOLDS_pri,1989,2011,22,5.1799998
GHA,lfoHOUSEHOLDS_price,1989,2011,22,4.1199999
GHA,lpgHOUSEHOLDS_price,1989,2011,22,1.25
GHA,unprem95HOUSEHOLDS_p,1989,2011,22,4.73
GHA,hsfoINDUSTRY_price,1989,2011,22,4.6399999
GRC,dieselHOUSEHOLDS_atp,1978,2016,38,.94999999
GRC,dieselINDUSTRY_atpri,1978,2016,38,.94999999
GRC,electrHOUSEHOLDS_atp,1978,2016,38,-.69999999
GRC,electrINDUSTRY_atpri,1978,2016,38,.0099999998
GRC,hsfoINDUSTRY_atprice,1978,2006,28,2.1800001
GRC,leadpremHOUSEHOLDS_a,1978,2016,38,-100
GRC,lfoHOUSEHOLDS_atpric,1978,2016,38,.31999999
GRC,lfoINDUSTRY_atprice,1978,2016,38,.31999999
GRC,lsfoINDUSTRY_atprice,1995,2016,21,2.03
GRC,natgasHOUSEHOLDS_atp,1998,2016,18,4.4899998
GRC,natgasINDUSTRY_atpri,1997,2016,19,-.13
GRC,unprem95HOUSEHOLDS_a,1988,2016,28,.77999997
GRC,dieselHOUSEHOLDS_pri,1978,2016,38,2.3099999
GRC,electrHOUSEHOLDS_pri,1978,2016,38,.059999999
GRC,leadpremHOUSEHOLDS_p,1978,2016,38,-100
GRC,lfoHOUSEHOLDS_price,1978,2016,38,1.58
GRC,natgasHOUSEHOLDS_pri,1998,2016,18,4.6399999
GRC,unprem95HOUSEHOLDS_p,1988,2016,28,1.35
GRC,dieselINDUSTRY_price,1978,2016,38,1.75
GRC,electrINDUSTRY_price,1978,2016,38,.58999997
GRC,hsfoINDUSTRY_price,1978,2006,28,2.24
GRC,lfoINDUSTRY_price,1978,2016,38,1.02
GRC,lsfoINDUSTRY_price,1995,2016,21,1.13
GRC,natgasINDUSTRY_price,1997,2016,19,1.14
HRV,electrHOUSEHOLDS_atp,2005,2010,5,3.79
HRV,electrINDUSTRY_atpri,2005,2010,5,9.8900003
HRV,dieselHOUSEHOLDS_pri,1998,2010,12,6.02
HRV,electrHOUSEHOLDS_pri,1994,2010,16,3.4200001
HRV,leadpremHOUSEHOLDS_p,1996,2005,9,3.7
HRV,lfoHOUSEHOLDS_price,1996,2010,14,4.3400002
HRV,natgasHOUSEHOLDS_pri,2000,2010,10,9.0100002
HRV,unprem95HOUSEHOLDS_p,1996,2010,14,3.4400001
HRV,unprem98HOUSEHOLDS_p,1998,2010,12,5.4699998
HRV,bitcoalINDUSTRY_pric,2005,2010,5,5.3200002
HRV,dieselINDUSTRY_price,2000,2010,10,5.1700001
HRV,electrINDUSTRY_price,2005,2010,5,9.5100002
HRV,natgasINDUSTRY_price,2000,2010,10,8.2700005
HUN,bitcoalHOUSEHOLDS_at,1980,2016,36,1.73
HUN,bitcoalINDUSTRY_atpr,1980,1998,18,-1.67
HUN,dieselHOUSEHOLDS_atp,1980,2016,36,.1
HUN,dieselINDUSTRY_atpri,1980,2016,36,.1
HUN,electrHOUSEHOLDS_atp,1980,2016,36,.60000002
HUN,electrINDUSTRY_atpri,1985,2016,31,.039999999
HUN,hsfoINDUSTRY_atprice,1980,2002,22,-.97000003
HUN,leadregHOUSEHOLDS_at,1980,1995,15,-4.7800002
HUN,lfoHOUSEHOLDS_atpric,1980,1994,14,4.04
HUN,lfoINDUSTRY_atprice,1980,2003,23,1.54
HUN,lpgHOUSEHOLDS_atpric,2001,2016,15,-1.55
HUN,lsfoINDUSTRY_atprice,1995,2016,21,4.3899999
HUN,natgasHOUSEHOLDS_atp,1980,2016,36,2.1099999
HUN,natgasINDUSTRY_atpri,1980,2016,36,1.03
HUN,unprem95HOUSEHOLDS_a,1992,2016,24,.14
HUN,unprem98HOUSEHOLDS_a,1996,2006,10,4.9400001
HUN,unregHOUSEHOLDS_atpr,1993,2003,10,1.03
HUN,bitcoalHOUSEHOLDS_pr,1980,2016,36,2.4000001
HUN,dieselHOUSEHOLDS_pri,1980,2016,36,2.3900001
HUN,electrHOUSEHOLDS_pri,1980,2016,36,1.27
HUN,leadregHOUSEHOLDS_pr,1980,1995,15,2.27
HUN,lfoHOUSEHOLDS_price,1980,1994,14,4.75
HUN,lpgHOUSEHOLDS_price,2001,2016,15,.97000003
HUN,natgasHOUSEHOLDS_pri,1980,2016,36,2.79
HUN,unprem95HOUSEHOLDS_p,1992,2016,24,-.51999998
HUN,unprem98HOUSEHOLDS_p,1996,2006,10,2.75
HUN,unregHOUSEHOLDS_pric,1993,2003,10,.70999998
HUN,bitcoalINDUSTRY_pric,1980,1998,18,-1.67
HUN,dieselINDUSTRY_price,1980,2016,36,1.71
HUN,electrINDUSTRY_price,1985,2016,31,.37
HUN,hsfoINDUSTRY_price,1980,2002,22,-.97000003
HUN,lfoINDUSTRY_price,1980,2003,23,3.8499999
HUN,lsfoINDUSTRY_price,1995,2016,21,4.6399999
HUN,natgasINDUSTRY_price,1980,2016,36,1.14
IDN,dieselHOUSEHOLDS_pri,1980,2009,29,4.3899999
IDN,electrHOUSEHOLDS_pri,1988,2010,22,-1.75
IDN,leadpremHOUSEHOLDS_p,1978,2009,31,.43000001
IDN,lfoHOUSEHOLDS_price,1980,2009,29,2.6400001
IDN,natgasHOUSEHOLDS_pri,1990,2000,10,-15.83
IDN,unprem95HOUSEHOLDS_p,2003,2010,7,12.49
IDN,unprem98HOUSEHOLDS_p,2003,2010,7,11.6
IDN,unregHOUSEHOLDS_pric,1980,2004,24,-5.0599999
IDN,bitcoalINDUSTRY_pric,1990,2009,19,-.57999998
IDN,dieselINDUSTRY_price,1978,2010,32,5.77
IDN,electrINDUSTRY_price,1988,2010,22,.28
IDN,hsfoINDUSTRY_price,1980,2008,28,5.6700001
IDN,lfoINDUSTRY_price,1980,2008,28,6.1900001
IDN,natgasINDUSTRY_price,1990,2000,10,-1.13
IND,bitcoalHOUSEHOLDS_at,1979,1990,11,-7
IND,bitcoalINDUSTRY_atpr,1978,2009,31,.62
IND,cokcoalINDUSTRY_atpr,1979,2009,30,1.5599999
IND,dieselINDUSTRY_atpri,1978,2010,32,3.9200001
IND,hsfoINDUSTRY_atprice,1978,2010,32,2.3900001
IND,leadpremHOUSEHOLDS_a,1978,1994,16,-3.3699999
IND,leadregHOUSEHOLDS_at,1978,2003,25,2.02
IND,lfoINDUSTRY_atprice,1978,2010,32,3.5799999
IND,lpgHOUSEHOLDS_atpric,2001,2010,9,3.5
IND,unregHOUSEHOLDS_atpr,2001,2010,9,9.0699997
IND,bitcoalHOUSEHOLDS_pr,1979,2005,26,4.27
IND,electrHOUSEHOLDS_pri,1992,2005,13,1.4
IND,leadpremHOUSEHOLDS_p,1978,1994,16,-4.7600002
IND,leadregHOUSEHOLDS_pr,1978,2003,25,-1.66
IND,lfoHOUSEHOLDS_price,1978,2010,32,-2.0599999
IND,lpgHOUSEHOLDS_price,2001,2010,9,1.86
IND,unregHOUSEHOLDS_pric,2001,2010,9,3.78
IND,bitcoalINDUSTRY_pric,1978,2009,31,1.1799999
IND,cokcoalINDUSTRY_pric,1979,2009,30,1.38
IND,dieselINDUSTRY_price,1978,2010,32,2.3099999
IND,electrINDUSTRY_price,1992,2000,8,.54000002
IND,hsfoINDUSTRY_price,1978,2010,32,1.79
IND,lfoINDUSTRY_price,1978,2010,32,2.8399999
IRL,bitcoalHOUSEHOLDS_at,1978,2016,38,.85000002
IRL,dieselHOUSEHOLDS_atp,1978,2016,38,-.039999999
IRL,dieselINDUSTRY_atpri,1978,2016,38,-.07
IRL,electrHOUSEHOLDS_atp,1978,2016,38,.66000003
IRL,electrINDUSTRY_atpri,1978,2016,38,.16
IRL,hsfoINDUSTRY_atprice,1978,2016,38,.75999999
IRL,leadpremHOUSEHOLDS_a,1978,2000,22,-.07
IRL,lfoHOUSEHOLDS_atpric,1978,2016,38,-.1
IRL,lfoINDUSTRY_atprice,1978,2016,38,-.1
IRL,natgasHOUSEHOLDS_atp,1978,2016,38,-.76999998
IRL,natgasINDUSTRY_atpri,1978,2016,38,-1.88
IRL,unprem95HOUSEHOLDS_a,1990,2016,26,-.80000001
IRL,unprem98HOUSEHOLDS_a,1992,2000,8,-1.1900001
IRL,bitcoalHOUSEHOLDS_pr,1978,2016,38,1.5599999
IRL,dieselHOUSEHOLDS_pri,1978,2016,38,1.22
IRL,electrHOUSEHOLDS_pri,1978,2016,38,1
IRL,leadpremHOUSEHOLDS_p,1978,2000,22,.61000001
IRL,lfoHOUSEHOLDS_price,1978,2016,38,.81999999
IRL,natgasHOUSEHOLDS_pri,1978,2016,38,-.28
IRL,unprem95HOUSEHOLDS_p,1990,2016,26,-.63999999
IRL,unprem98HOUSEHOLDS_p,1992,2000,8,-2.0999999
IRL,dieselINDUSTRY_price,1978,2016,38,.92000002
IRL,electrINDUSTRY_price,1978,2016,38,.16
IRL,hsfoINDUSTRY_price,1978,2016,38,1.12
IRL,lfoINDUSTRY_price,1978,2016,38,.47999999
IRL,natgasINDUSTRY_price,1978,2016,38,-1.55
ISR,dieselHOUSEHOLDS_atp,2001,2016,15,-.50999999
ISR,electrHOUSEHOLDS_atp,1994,2015,21,.36000001
ISR,electrINDUSTRY_atpri,1994,2015,21,0
ISR,leadregHOUSEHOLDS_at,1983,2008,25,-.60000002
ISR,lfoHOUSEHOLDS_atpric,2008,2016,8,-8.6199999
ISR,unprem95HOUSEHOLDS_a,1999,2016,17,1.17
ISR,dieselHOUSEHOLDS_pri,2001,2016,15,5.0900002
ISR,electrHOUSEHOLDS_pri,1994,2015,21,.40000001
ISR,leadpremHOUSEHOLDS_p,1986,2008,22,2.51
ISR,leadregHOUSEHOLDS_pr,1983,2008,25,1.66
ISR,lfoHOUSEHOLDS_price,1986,2016,30,2.6500001
ISR,unprem95HOUSEHOLDS_p,1999,2016,17,.99000001
ISR,electrINDUSTRY_price,1994,2015,21,0
ITA,bitcoalHOUSEHOLDS_at,1978,1983,5,-6.79
ITA,bitcoalINDUSTRY_atpr,1978,2011,33,-.56999999
ITA,cokcoalINDUSTRY_atpr,1978,2011,33,.86000001
ITA,dieselHOUSEHOLDS_atp,1978,2016,38,.40000001
ITA,dieselINDUSTRY_atpri,1978,2016,38,.40000001
ITA,electrHOUSEHOLDS_atp,1978,2016,38,.68000001
ITA,electrINDUSTRY_atpri,1978,2016,38,-.41999999
ITA,hsfoINDUSTRY_atprice,1978,2002,24,-.79000002
ITA,leadpremHOUSEHOLDS_a,1978,2001,23,-.74000001
ITA,lfoHOUSEHOLDS_atpric,1978,2016,38,.92000002
ITA,lfoINDUSTRY_atprice,1978,2016,38,.92000002
ITA,lpgHOUSEHOLDS_atpric,1997,2016,19,2.45
ITA,lpgINDUSTRY_atprice,1997,2016,19,2.45
ITA,lsfoINDUSTRY_atprice,1992,2016,24,1.11
ITA,natgasHOUSEHOLDS_atp,1978,2016,38,1.61
ITA,natgasINDUSTRY_atpri,1978,2016,38,1.14
ITA,unprem95HOUSEHOLDS_a,1990,2016,26,-.12
ITA,bitcoalHOUSEHOLDS_pr,1978,1983,5,-6.79
ITA,dieselHOUSEHOLDS_pri,1978,2016,38,2.48
ITA,electrHOUSEHOLDS_pri,1978,2016,38,1.66
ITA,leadpremHOUSEHOLDS_p,1978,2001,23,-1.27
ITA,lfoHOUSEHOLDS_price,1978,2016,38,2.3
ITA,lpgHOUSEHOLDS_price,1997,2016,19,1.64
ITA,natgasHOUSEHOLDS_pri,1978,2016,38,1.86
ITA,unprem95HOUSEHOLDS_p,1990,2016,26,-.89999998
ITA,bitcoalINDUSTRY_pric,1978,2011,33,-.56999999
ITA,cokcoalINDUSTRY_pric,1978,2011,33,.86000001
ITA,dieselINDUSTRY_price,1978,2016,38,2.25
ITA,electrINDUSTRY_price,1978,2016,38,.98000002
ITA,hsfoINDUSTRY_price,1978,2002,24,.47
ITA,lfoINDUSTRY_price,1978,2016,38,2.1099999
ITA,lpgINDUSTRY_price,1997,2016,19,1.52
ITA,lsfoINDUSTRY_price,1992,2016,24,.64999998
ITA,natgasINDUSTRY_price,1978,2016,38,1.4400001
JPN,bitcoalINDUSTRY_atpr,1989,2016,27,-1.01
JPN,cokcoalINDUSTRY_atpr,1978,2016,38,-2.25
JPN,dieselHOUSEHOLDS_atp,1978,2016,38,-.88999999
JPN,dieselINDUSTRY_atpri,1995,2016,21,.97000003
JPN,electrHOUSEHOLDS_atp,1978,2016,38,-.70999998
JPN,electrINDUSTRY_atpri,1978,2016,38,-.58999997
JPN,hsfoINDUSTRY_atprice,1978,2008,30,3.0699999
JPN,lfoHOUSEHOLDS_atpric,1978,2016,38,.12
JPN,lfoINDUSTRY_atprice,1978,2016,38,.0099999998
JPN,lpgHOUSEHOLDS_atpric,2002,2016,14,.62
JPN,lpgINDUSTRY_atprice,2002,2016,14,.47999999
JPN,lsfoINDUSTRY_atprice,1993,2016,23,-.2
JPN,natgasHOUSEHOLDS_atp,1978,2015,37,-.40000001
JPN,natgasINDUSTRY_atpri,1978,2015,37,-2.0899999
JPN,unregHOUSEHOLDS_atpr,1978,2016,38,-1.15
JPN,dieselHOUSEHOLDS_pri,1978,2016,38,-.52999997
JPN,electrHOUSEHOLDS_pri,1978,2016,38,-.57999998
JPN,lfoHOUSEHOLDS_price,1978,2016,38,.44999999
JPN,lpgHOUSEHOLDS_price,2002,2016,14,.58999997
JPN,natgasHOUSEHOLDS_pri,1978,2015,37,-.22
JPN,unregHOUSEHOLDS_pric,1978,2016,38,-.60000002
JPN,bitcoalINDUSTRY_pric,1978,2016,38,-1.5700001
JPN,cokcoalINDUSTRY_pric,1978,2016,38,-1.73
JPN,dieselINDUSTRY_price,1995,2016,21,-.63
JPN,electrINDUSTRY_price,1978,2016,38,-.41
JPN,hsfoINDUSTRY_price,1978,2008,30,3.24
JPN,lfoINDUSTRY_price,1978,2016,38,.36000001
JPN,lpgINDUSTRY_price,2002,2016,14,.46000001
JPN,lsfoINDUSTRY_price,1993,2016,23,0
JPN,natgasINDUSTRY_price,1978,2015,37,-1.92
KAZ,electrHOUSEHOLDS_atp,1994,2010,16,.25999999
KAZ,electrINDUSTRY_atpri,1998,2010,12,1.77
KAZ,leadregHOUSEHOLDS_at,1994,2009,15,2.52
KAZ,bitcoalHOUSEHOLDS_pr,1996,2010,14,.94
KAZ,electrHOUSEHOLDS_pri,1994,2010,16,-.17
KAZ,leadregHOUSEHOLDS_pr,1994,2009,15,1.4
KAZ,lfoHOUSEHOLDS_price,1996,2010,14,6.4400001
KAZ,natgasHOUSEHOLDS_pri,1996,2010,14,1.36
KAZ,bitcoalINDUSTRY_pric,1995,2010,15,3.3599999
KAZ,cokcoalINDUSTRY_pric,1995,2010,15,-1.59
KAZ,electrINDUSTRY_price,1996,2010,14,3.79
KAZ,hsfoINDUSTRY_price,1995,2010,15,6.2199998
KAZ,lfoINDUSTRY_price,1996,2010,14,6.5300002
KAZ,natgasINDUSTRY_price,1996,2010,14,1.12
KOR,dieselHOUSEHOLDS_atp,1997,2016,19,.46000001
KOR,electrHOUSEHOLDS_atp,1997,2016,19,-1.45
KOR,electrINDUSTRY_atpri,1997,2016,19,1.1
KOR,hsfoINDUSTRY_atprice,2000,2016,16,-.91000003
KOR,lfoHOUSEHOLDS_atpric,1997,2016,19,1.24
KOR,lfoINDUSTRY_atprice,2000,2010,10,5.2800002
KOR,lpgHOUSEHOLDS_atpric,2001,2016,15,.64999998
KOR,lsfoINDUSTRY_atprice,2000,2016,16,.34999999
KOR,natgasHOUSEHOLDS_atp,2001,2016,15,1.3099999
KOR,natgasINDUSTRY_atpri,2001,2016,15,1.16
KOR,unprem95HOUSEHOLDS_a,2009,2016,7,-.68000001
KOR,unregHOUSEHOLDS_atpr,1997,2016,19,.31
KOR,dieselHOUSEHOLDS_pri,1979,2016,37,1.22
KOR,electrHOUSEHOLDS_pri,1978,2016,38,-1.3200001
KOR,leadpremHOUSEHOLDS_p,1980,1996,16,-4.48
KOR,leadregHOUSEHOLDS_pr,1980,1996,16,-4.1500001
KOR,lfoHOUSEHOLDS_price,1980,2016,36,-.38
KOR,lpgHOUSEHOLDS_price,2001,2016,15,2.24
KOR,natgasHOUSEHOLDS_pri,2001,2016,15,1.3099999
KOR,unprem95HOUSEHOLDS_p,2009,2016,7,-.44999999
KOR,unregHOUSEHOLDS_pric,1987,2016,29,-.07
KOR,bitcoalINDUSTRY_pric,1980,2009,29,.83999997
KOR,cokcoalINDUSTRY_pric,2004,2009,5,15.75
KOR,electrINDUSTRY_price,1978,2016,38,-.74000001
KOR,hsfoINDUSTRY_price,1979,2016,37,-1.17
KOR,lfoINDUSTRY_price,1998,2010,12,6.04
KOR,lsfoINDUSTRY_price,1998,2016,18,1.79
KOR,natgasINDUSTRY_price,2001,2016,15,1.16
LTU,dieselHOUSEHOLDS_atp,2005,2011,6,8.0200005
LTU,dieselINDUSTRY_atpri,2005,2011,6,8.0200005
LTU,hsfoINDUSTRY_atprice,2005,2011,6,16.870001
LTU,lfoHOUSEHOLDS_atpric,2005,2011,6,8.9700003
LTU,lfoINDUSTRY_atprice,2005,2011,6,8.9700003
LTU,lpgHOUSEHOLDS_atpric,2005,2011,6,4.5
LTU,lpgINDUSTRY_atprice,2005,2011,6,4.5
LTU,unprem95HOUSEHOLDS_a,2005,2011,6,8.04
LTU,dieselHOUSEHOLDS_pri,2005,2011,6,6.9699998
LTU,lfoHOUSEHOLDS_price,2005,2011,6,9.04
LTU,lpgHOUSEHOLDS_price,2005,2011,6,7.7600002
LTU,unprem95HOUSEHOLDS_p,2005,2011,6,8.0900002
LTU,dieselINDUSTRY_price,2005,2011,6,6.52
LTU,hsfoINDUSTRY_price,2005,2011,6,15.92
LTU,lfoINDUSTRY_price,2005,2011,6,8.5799999
LTU,lpgINDUSTRY_price,2005,2011,6,7.3099999
LUX,bitcoalHOUSEHOLDS_at,1978,2005,27,.25999999
LUX,dieselHOUSEHOLDS_atp,1979,2016,37,-.50999999
LUX,dieselINDUSTRY_atpri,1979,2016,37,-.49000001
LUX,electrHOUSEHOLDS_atp,1978,2016,38,-.82999998
LUX,electrINDUSTRY_atpri,1978,2016,38,-1.45
LUX,hsfoINDUSTRY_atprice,1981,1994,13,-7.3200002
LUX,leadpremHOUSEHOLDS_a,1979,1998,19,-3.53
LUX,lfoHOUSEHOLDS_atpric,1979,2016,37,-.56
LUX,lfoINDUSTRY_atprice,1981,2016,35,-1.29
LUX,lpgHOUSEHOLDS_atpric,2000,2016,16,-.34
LUX,lpgINDUSTRY_atprice,2000,2016,16,-.41999999
LUX,lsfoINDUSTRY_atprice,1995,2004,9,1.66
LUX,natgasHOUSEHOLDS_atp,1978,2016,38,.22
LUX,natgasINDUSTRY_atpri,1979,2016,37,.16
LUX,unprem95HOUSEHOLDS_a,1990,2016,26,0
LUX,unprem98HOUSEHOLDS_a,1994,2016,22,1.71
LUX,unregHOUSEHOLDS_atpr,1994,2004,10,4.4499998
LUX,bitcoalHOUSEHOLDS_pr,1978,2005,27,.5
LUX,dieselHOUSEHOLDS_pri,1979,2016,37,.60000002
LUX,electrHOUSEHOLDS_pri,1978,2016,38,-.28999999
LUX,leadpremHOUSEHOLDS_p,1979,1998,19,-.68000001
LUX,lfoHOUSEHOLDS_price,1979,2016,37,-.44
LUX,lpgHOUSEHOLDS_price,2000,2016,16,-.30000001
LUX,natgasHOUSEHOLDS_pri,1978,2016,38,.36000001
LUX,unprem95HOUSEHOLDS_p,1990,2016,26,.41999999
LUX,unprem98HOUSEHOLDS_p,1994,2016,22,.64999998
LUX,unregHOUSEHOLDS_pric,1994,2004,10,2.79
LUX,dieselINDUSTRY_price,1979,2016,37,.31999999
LUX,electrINDUSTRY_price,1978,2016,38,-1.0599999
LUX,hsfoINDUSTRY_price,1981,1994,13,-6.4299998
LUX,lfoINDUSTRY_price,1981,2016,35,-1.14
LUX,lpgINDUSTRY_price,2000,2016,16,-.47
LUX,lsfoINDUSTRY_price,1995,2004,9,1.91
LUX,natgasINDUSTRY_price,1979,2016,37,.20999999
MEX,dieselHOUSEHOLDS_atp,1978,2016,38,5.29
MEX,dieselINDUSTRY_atpri,1978,2016,38,5.5
MEX,electrHOUSEHOLDS_atp,1978,2016,38,-1.6799999
MEX,electrINDUSTRY_atpri,1978,2016,38,.2
MEX,hsfoINDUSTRY_atprice,1978,2016,38,4
MEX,leadregHOUSEHOLDS_at,1978,1997,19,1.33
MEX,lfoINDUSTRY_atprice,1978,2016,38,2.1199999
MEX,natgasHOUSEHOLDS_atp,2004,2016,12,-7
MEX,natgasINDUSTRY_atpri,1978,2008,30,8.6700001
MEX,unprem95HOUSEHOLDS_a,1996,2016,20,3.8299999
MEX,unregHOUSEHOLDS_atpr,1978,2016,38,.44999999
MEX,dieselHOUSEHOLDS_pri,1978,2016,38,5.6999998
MEX,electrHOUSEHOLDS_pri,1978,2016,38,-1.29
MEX,leadregHOUSEHOLDS_pr,1978,1997,19,2.0799999
MEX,natgasHOUSEHOLDS_pri,2004,2016,12,-6.9299998
MEX,unprem95HOUSEHOLDS_p,1996,2016,20,1.64
MEX,unregHOUSEHOLDS_pric,1978,2016,38,.83999997
MEX,dieselINDUSTRY_price,1978,2016,38,5.5
MEX,electrINDUSTRY_price,1978,2016,38,.2
MEX,hsfoINDUSTRY_price,1978,2016,38,4
MEX,lfoINDUSTRY_price,1978,2016,38,2.1199999
MEX,natgasINDUSTRY_price,1978,2008,30,8.6700001
MLT,dieselHOUSEHOLDS_atp,2005,2011,6,6.29
MLT,dieselINDUSTRY_atpri,2005,2011,6,6.29
MLT,hsfoINDUSTRY_atprice,2005,2009,4,16.629999
MLT,lfoHOUSEHOLDS_atpric,2005,2011,6,8.1499996
MLT,lfoINDUSTRY_atprice,2005,2011,6,8.1499996
MLT,unprem95HOUSEHOLDS_a,2005,2011,6,6.2199998
MLT,dieselHOUSEHOLDS_pri,2005,2011,6,6.7800002
MLT,lfoHOUSEHOLDS_price,2005,2011,6,14.23
MLT,unprem95HOUSEHOLDS_p,2005,2011,6,6.6100001
MLT,dieselINDUSTRY_price,2005,2011,6,6.7800002
MLT,hsfoINDUSTRY_price,2005,2009,4,15.89
MLT,lfoINDUSTRY_price,2005,2011,6,11.12
NLD,bitcoalHOUSEHOLDS_at,1978,1987,9,2.24
NLD,bitcoalINDUSTRY_atpr,1978,1991,13,-4.4200001
NLD,cokcoalINDUSTRY_atpr,1978,1991,13,-2.4400001
NLD,dieselHOUSEHOLDS_atp,1978,2016,38,.20999999
NLD,dieselINDUSTRY_atpri,1978,2016,38,.19
NLD,electrHOUSEHOLDS_atp,1978,2016,38,-.89999998
NLD,electrINDUSTRY_atpri,1978,2016,38,-.80000001
NLD,hsfoINDUSTRY_atprice,1978,1996,18,-1.26
NLD,leadpremHOUSEHOLDS_a,1978,2008,30,2.3
NLD,lfoHOUSEHOLDS_atpric,1978,2016,38,-.83999997
NLD,lfoINDUSTRY_atprice,1978,2016,38,-.69999999
NLD,lpgHOUSEHOLDS_atpric,2000,2016,16,-1.5
NLD,lpgINDUSTRY_atprice,2000,2016,16,-1.5
NLD,lsfoINDUSTRY_atprice,1997,2016,19,4.7600002
NLD,natgasHOUSEHOLDS_atp,1978,2016,38,.30000001
NLD,natgasINDUSTRY_atpri,1978,2016,38,.079999998
NLD,unprem95HOUSEHOLDS_a,1985,2016,31,-.059999999
NLD,unprem98HOUSEHOLDS_a,1990,2009,19,.75
NLD,bitcoalHOUSEHOLDS_pr,1978,1987,9,2.4300001
NLD,dieselHOUSEHOLDS_pri,1978,2016,38,1.0599999
NLD,electrHOUSEHOLDS_pri,1978,2016,38,-.86000001
NLD,leadpremHOUSEHOLDS_p,1978,2008,30,2
NLD,lfoHOUSEHOLDS_price,1978,2016,38,1.75
NLD,lpgHOUSEHOLDS_price,2000,2016,16,.67000002
NLD,natgasHOUSEHOLDS_pri,1978,2016,38,1.83
NLD,unprem95HOUSEHOLDS_p,1985,2016,31,1.3
NLD,unprem98HOUSEHOLDS_p,1990,2009,19,1.54
NLD,bitcoalINDUSTRY_pric,1978,1991,13,-4.4200001
NLD,cokcoalINDUSTRY_pric,1978,1991,13,-2.4400001
NLD,dieselINDUSTRY_price,1978,2016,38,1
NLD,electrINDUSTRY_price,1978,2016,38,-.20999999
NLD,hsfoINDUSTRY_price,1978,1996,18,-.37
NLD,lfoINDUSTRY_price,1978,2016,38,1.8099999
NLD,lpgINDUSTRY_price,2000,2016,16,.49000001
NLD,lsfoINDUSTRY_price,1997,2016,19,4.04
NLD,natgasINDUSTRY_price,1978,2016,38,.52999997
NOR,bitcoalHOUSEHOLDS_at,1979,1985,6,-3.52
NOR,bitcoalINDUSTRY_atpr,1978,1994,16,-3.3299999
NOR,cokcoalINDUSTRY_atpr,1979,1995,16,-4.5999999
NOR,dieselHOUSEHOLDS_atp,1996,2016,20,-.5
NOR,dieselINDUSTRY_atpri,1978,2016,38,.41
NOR,electrHOUSEHOLDS_atp,1978,2016,38,.17
NOR,electrINDUSTRY_atpri,1978,2016,38,.69999999
NOR,hsfoINDUSTRY_atprice,1978,1994,16,-.20999999
NOR,leadpremHOUSEHOLDS_a,1978,2010,32,1.4400001
NOR,lfoHOUSEHOLDS_atpric,1978,2016,38,1.34
NOR,lfoINDUSTRY_atprice,1978,2016,38,1.45
NOR,lsfoINDUSTRY_atprice,1995,2002,7,1.52
NOR,unprem95HOUSEHOLDS_a,1986,2016,30,.55000001
NOR,unprem98HOUSEHOLDS_a,1990,2012,22,2.6600001
NOR,bitcoalHOUSEHOLDS_pr,1979,1985,6,-3.52
NOR,dieselHOUSEHOLDS_pri,1996,2016,20,-1.01
NOR,electrHOUSEHOLDS_pri,1978,2016,38,.56999999
NOR,leadpremHOUSEHOLDS_p,1978,2010,32,1.5700001
NOR,lfoHOUSEHOLDS_price,1978,2016,38,2.0599999
NOR,unprem95HOUSEHOLDS_p,1986,2016,30,1.05
NOR,unprem98HOUSEHOLDS_p,1990,2012,22,2.3699999
NOR,bitcoalINDUSTRY_pric,1978,1994,16,-3.3299999
NOR,cokcoalINDUSTRY_pric,1979,1995,16,-4.5999999
NOR,dieselINDUSTRY_price,1978,2016,38,2.1600001
NOR,electrINDUSTRY_price,1978,2016,38,.55000001
NOR,hsfoINDUSTRY_price,1978,1994,16,3.26
NOR,lfoINDUSTRY_price,1978,2016,38,2.0599999
NOR,lsfoINDUSTRY_price,1995,2002,7,1.7
NZL,bitcoalINDUSTRY_atpr,1978,1984,6,-5.5900002
NZL,dieselHOUSEHOLDS_atp,1978,2016,38,.54000002
NZL,dieselINDUSTRY_atpri,1978,2016,38,-.25
NZL,electrHOUSEHOLDS_atp,1978,2015,37,2.3
NZL,electrINDUSTRY_atpri,1978,2014,36,1.5
NZL,hsfoINDUSTRY_atprice,1978,2016,38,-.33000001
NZL,leadpremHOUSEHOLDS_a,1978,1995,17,-.5
NZL,lfoHOUSEHOLDS_atpric,1978,1987,9,-2.1400001
NZL,lfoINDUSTRY_atprice,1978,2016,38,-.82999998
NZL,natgasHOUSEHOLDS_atp,1985,2016,31,5.0900002
NZL,natgasINDUSTRY_atpri,1985,2016,31,2.3099999
NZL,unprem95HOUSEHOLDS_a,1997,2016,19,2.1300001
NZL,unregHOUSEHOLDS_atpr,1990,2016,26,.61000001
NZL,dieselHOUSEHOLDS_pri,1978,2016,38,.86000001
NZL,electrHOUSEHOLDS_pri,1978,2015,37,2.6800001
NZL,leadpremHOUSEHOLDS_p,1978,1995,17,-.14
NZL,lfoHOUSEHOLDS_price,1978,1987,9,4.0500002
NZL,natgasHOUSEHOLDS_pri,1985,2016,31,5.3200002
NZL,unprem95HOUSEHOLDS_p,1997,2016,19,2.27
NZL,unregHOUSEHOLDS_pric,1990,2016,26,1.02
NZL,bitcoalINDUSTRY_pric,1978,1984,6,-5.8099999
NZL,dieselINDUSTRY_price,1978,2016,38,-.30000001
NZL,electrINDUSTRY_price,1978,2014,36,1.5
NZL,hsfoINDUSTRY_price,1978,2016,38,-.68000001
NZL,lfoINDUSTRY_price,1978,2016,38,-.89999998
NZL,natgasINDUSTRY_price,1985,2016,31,1.89
OEU,bitcoalHOUSEHOLDS_pr,1978,2016,38,-.46000001
OEU,dieselHOUSEHOLDS_pri,1978,2016,38,.69
OEU,electrHOUSEHOLDS_pri,1978,2016,38,.07
OEU,leadpremHOUSEHOLDS_p,1978,1996,18,.61000001
OEU,lfoHOUSEHOLDS_price,1978,2016,38,.86000001
OEU,natgasHOUSEHOLDS_pri,1978,2016,38,1.26
OEU,unprem95HOUSEHOLDS_p,1985,2016,31,.83999997
OEU,unprem98HOUSEHOLDS_p,1995,2009,14,1.5599999
OEU,bitcoalINDUSTRY_pric,1978,2000,22,-4.0900002
OEU,cokcoalINDUSTRY_pric,1978,1997,19,-3.98
OEU,dieselINDUSTRY_price,1978,2016,38,.64999998
OEU,electrINDUSTRY_price,1978,2016,38,.090000004
OEU,hsfoINDUSTRY_price,1978,1999,21,-1.42
OEU,lfoINDUSTRY_price,1978,2016,38,1.03
OEU,lsfoINDUSTRY_price,2001,2016,15,1.77
OEU,natgasINDUSTRY_price,1978,2016,38,.63
OTO,bitcoalHOUSEHOLDS_pr,1978,2016,38,-.46000001
OTO,dieselHOUSEHOLDS_pri,1978,2016,38,.63999999
OTO,electrHOUSEHOLDS_pri,1978,2016,38,-.039999999
OTO,lfoHOUSEHOLDS_price,1978,2016,38,1.04
OTO,natgasHOUSEHOLDS_pri,1978,2016,38,1.15
OTO,unprem95HOUSEHOLDS_p,1980,2016,36,-.2
OTO,unprem98HOUSEHOLDS_p,1993,2016,23,.52999997
OTO,unregHOUSEHOLDS_pric,1978,2016,38,.37
OTO,bitcoalINDUSTRY_pric,1978,2010,32,-.43000001
OTO,cokcoalINDUSTRY_pric,1978,1997,19,-3.8099999
OTO,dieselINDUSTRY_price,1978,2016,38,.11
OTO,electrINDUSTRY_price,1978,2016,38,-.18000001
OTO,hsfoINDUSTRY_price,1978,2006,28,2.1800001
OTO,lfoINDUSTRY_price,1978,2016,38,.50999999
OTO,natgasINDUSTRY_price,1978,2016,38,.13
PAK,dieselHOUSEHOLDS_atp,2002,2009,7,10.41
PAK,lfoHOUSEHOLDS_atpric,2002,2009,7,10.48
PAK,unregHOUSEHOLDS_atpr,2002,2009,7,5.52
PAK,dieselHOUSEHOLDS_pri,2002,2009,7,10.98
PAK,lfoHOUSEHOLDS_price,2002,2009,7,10.82
PAK,unregHOUSEHOLDS_pric,2002,2009,7,1.87
PAK,hsfoINDUSTRY_price,2002,2009,7,10.55
PAK,natgasINDUSTRY_price,2003,2009,6,2.98
POL,bitcoalHOUSEHOLDS_at,1986,2016,30,5.5599999
POL,bitcoalINDUSTRY_atpr,1986,2011,25,6.3800001
POL,cokcoalINDUSTRY_atpr,1986,2011,25,6.1500001
POL,dieselHOUSEHOLDS_atp,1993,2016,23,1.38
POL,dieselINDUSTRY_atpri,1986,2016,30,2.6900001
POL,electrHOUSEHOLDS_atp,1978,2016,38,-5.1300001
POL,electrINDUSTRY_atpri,1981,2016,35,1.58
POL,hsfoINDUSTRY_atprice,1986,2016,30,.0099999998
POL,leadpremHOUSEHOLDS_a,1986,2000,14,4.1700001
POL,lfoHOUSEHOLDS_atpric,1994,2016,22,.07
POL,lfoINDUSTRY_atprice,1986,2016,30,2.24
POL,lpgHOUSEHOLDS_atpric,2003,2016,13,-1.4299999
POL,lpgINDUSTRY_atprice,2003,2016,13,-1.4299999
POL,lsfoINDUSTRY_atprice,2004,2016,12,2.4400001
POL,natgasHOUSEHOLDS_atp,1979,2016,37,5.4000001
POL,natgasINDUSTRY_atpri,1979,2016,37,1.88
POL,unprem95HOUSEHOLDS_a,1994,2016,22,2.1400001
POL,unprem98HOUSEHOLDS_a,1995,2016,21,1.76
POL,bitcoalHOUSEHOLDS_pr,1986,2016,30,6.29
POL,dieselHOUSEHOLDS_pri,1993,2016,23,2.3299999
POL,electrHOUSEHOLDS_pri,1978,2016,38,-4.5100002
POL,leadpremHOUSEHOLDS_p,1986,2000,14,2.98
POL,lfoHOUSEHOLDS_price,1994,2016,22,1.24
POL,lpgHOUSEHOLDS_price,2003,2016,13,-.28999999
POL,natgasHOUSEHOLDS_pri,1979,2016,37,5.9899998
POL,unprem95HOUSEHOLDS_p,1994,2016,22,2.0599999
POL,unprem98HOUSEHOLDS_p,1995,2016,21,1.9299999
POL,bitcoalINDUSTRY_pric,1986,2016,30,2.9400001
POL,cokcoalINDUSTRY_pric,1986,2016,30,1.72
POL,dieselINDUSTRY_price,1986,2016,30,2.26
POL,electrINDUSTRY_price,1981,2016,35,1.77
POL,hsfoINDUSTRY_price,1986,2016,30,.25
POL,lfoINDUSTRY_price,1986,2016,30,2.6400001
POL,lpgINDUSTRY_price,2003,2016,13,-.36000001
POL,lsfoINDUSTRY_price,2004,2016,12,2.8599999
POL,natgasINDUSTRY_price,1979,2016,37,1.91
PRT,bitcoalINDUSTRY_atpr,1997,2015,18,1.37
PRT,cokcoalINDUSTRY_atpr,1978,2016,38,-1.08
PRT,dieselHOUSEHOLDS_atp,1978,2016,38,.55000001
PRT,dieselINDUSTRY_atpri,1978,2016,38,.55000001
PRT,electrHOUSEHOLDS_atp,1978,2016,38,0
PRT,electrINDUSTRY_atpri,1978,2016,38,.72000003
PRT,hsfoINDUSTRY_atprice,1978,2002,24,-.70999998
PRT,leadpremHOUSEHOLDS_a,1978,2010,32,1.91
PRT,lfoHOUSEHOLDS_atpric,2004,2016,12,-1.12
PRT,lpgHOUSEHOLDS_atpric,2002,2016,14,-1.4400001
PRT,lsfoINDUSTRY_atprice,1995,2016,21,3.04
PRT,natgasHOUSEHOLDS_atp,2002,2016,14,.38
PRT,natgasINDUSTRY_atpri,2002,2016,14,1.59
PRT,unprem95HOUSEHOLDS_a,1987,2016,29,0
PRT,unprem98HOUSEHOLDS_a,1994,2016,22,1.27
PRT,dieselHOUSEHOLDS_pri,1978,2016,38,2.4400001
PRT,electrHOUSEHOLDS_pri,1978,2016,38,1.7
PRT,leadpremHOUSEHOLDS_p,1978,2010,32,.63999999
PRT,lfoHOUSEHOLDS_price,2004,2016,12,2.7
PRT,lpgHOUSEHOLDS_price,2002,2016,14,.49000001
PRT,natgasHOUSEHOLDS_pri,2002,2016,14,1.97
PRT,unprem95HOUSEHOLDS_p,1987,2016,29,-.039999999
PRT,unprem98HOUSEHOLDS_p,1994,2016,22,.64999998
PRT,bitcoalINDUSTRY_pric,1997,2015,18,1.62
PRT,cokcoalINDUSTRY_pric,1978,2016,38,-.93000001
PRT,dieselINDUSTRY_price,1978,2016,38,2.1800001
PRT,electrINDUSTRY_price,1978,2016,38,1.1900001
PRT,hsfoINDUSTRY_price,1978,2002,24,1.14
PRT,lsfoINDUSTRY_price,1995,2016,21,2.99
PRT,natgasINDUSTRY_price,2002,2016,14,1.74
ROU,electrHOUSEHOLDS_atp,1995,2010,15,
ROU,electrINDUSTRY_atpri,1995,2010,15,
ROU,bitcoalHOUSEHOLDS_pr,1991,2010,19,13.14
ROU,dieselHOUSEHOLDS_pri,1991,2010,19,4.3699999
ROU,electrHOUSEHOLDS_pri,1991,2010,19,13.45
ROU,leadpremHOUSEHOLDS_p,1991,2008,17,4.3899999
ROU,leadregHOUSEHOLDS_pr,1991,2000,9,-1.75
ROU,natgasHOUSEHOLDS_pri,1991,2010,19,17.27
ROU,unprem95HOUSEHOLDS_p,1993,2010,17,10.04
ROU,electrINDUSTRY_price,1995,2010,15,5.0500002
RUS,dieselHOUSEHOLDS_pri,1998,2010,12,6.3699999
RUS,leadregHOUSEHOLDS_pr,1993,2000,7,4.5300002
RUS,natgasHOUSEHOLDS_pri,1993,2004,11,26.309999
RUS,unprem95HOUSEHOLDS_p,1997,2010,13,3.3499999
RUS,unprem98HOUSEHOLDS_p,2001,2010,9,12.08
RUS,unregHOUSEHOLDS_pric,2001,2010,9,12.79
RUS,bitcoalINDUSTRY_pric,2004,2010,6,6.8099999
RUS,cokcoalINDUSTRY_pric,1993,2010,17,9.8800001
RUS,electrINDUSTRY_price,2001,2010,9,7.8000002
RUS,hsfoINDUSTRY_price,2004,2010,6,20.209999
RUS,natgasINDUSTRY_price,1993,2010,17,11.98
SGP,electrHOUSEHOLDS_atp,2002,2010,8,6.2800002
SGP,electrINDUSTRY_atpri,2002,2010,8,7.4699998
SGP,dieselHOUSEHOLDS_pri,2000,2010,10,7.9099998
SGP,electrHOUSEHOLDS_pri,2002,2010,8,6.79
SGP,lpgHOUSEHOLDS_price,2001,2010,9,6.0900002
SGP,unprem95HOUSEHOLDS_p,2000,2010,10,2.3099999
SGP,unregHOUSEHOLDS_pric,2000,2010,10,2.6800001
SGP,electrINDUSTRY_price,2002,2010,8,7.98
SVK,bitcoalHOUSEHOLDS_at,1978,1990,12,2.6600001
SVK,bitcoalINDUSTRY_atpr,1978,1999,21,3.0999999
SVK,cokcoalINDUSTRY_atpr,1978,1992,14,.77999997
SVK,dieselHOUSEHOLDS_atp,1985,2016,31,2.1099999
SVK,dieselINDUSTRY_atpri,1978,2016,38,2.98
SVK,electrHOUSEHOLDS_atp,1978,2016,38,.87
SVK,electrINDUSTRY_atpri,1978,2016,38,1.85
SVK,hsfoINDUSTRY_atprice,1978,1999,21,-3.3199999
SVK,leadpremHOUSEHOLDS_a,1978,1996,18,3.6400001
SVK,leadregHOUSEHOLDS_at,1993,2003,10,1.1
SVK,lfoHOUSEHOLDS_atpric,1978,2003,25,3.73
SVK,lfoINDUSTRY_atprice,1978,2016,38,2.6300001
SVK,lpgHOUSEHOLDS_atpric,2002,2016,14,.41
SVK,lpgINDUSTRY_atprice,2002,2016,14,.49000001
SVK,lsfoINDUSTRY_atprice,2001,2016,15,3.9000001
SVK,natgasHOUSEHOLDS_atp,1978,2016,38,2.9000001
SVK,natgasINDUSTRY_atpri,1978,2016,38,2.0999999
SVK,unprem95HOUSEHOLDS_a,1989,2016,27,2.3699999
SVK,unprem98HOUSEHOLDS_a,1989,2007,18,6.0900002
SVK,bitcoalHOUSEHOLDS_pr,1978,2016,38,7.1999998
SVK,dieselHOUSEHOLDS_pri,1985,2016,31,2.03
SVK,electrHOUSEHOLDS_pri,1978,2016,38,1.35
SVK,leadpremHOUSEHOLDS_p,1978,1996,18,-2.0599999
SVK,leadregHOUSEHOLDS_pr,1993,2003,10,1.05
SVK,lfoHOUSEHOLDS_price,1978,2003,25,4.5
SVK,lpgHOUSEHOLDS_price,2002,2016,14,1.8
SVK,natgasHOUSEHOLDS_pri,1978,2016,38,3.8299999
SVK,unprem95HOUSEHOLDS_p,1989,2016,27,1.02
SVK,unprem98HOUSEHOLDS_p,1989,2007,18,3.3900001
SVK,bitcoalINDUSTRY_pric,1978,1999,21,3.0999999
SVK,cokcoalINDUSTRY_pric,1978,1992,14,.77999997
SVK,dieselINDUSTRY_price,1978,2016,38,2.29
SVK,electrINDUSTRY_price,1978,2016,38,1.88
SVK,hsfoINDUSTRY_price,1978,1999,21,-3.3199999
SVK,lfoINDUSTRY_price,1978,2016,38,2.6300001
SVK,lpgINDUSTRY_price,2002,2016,14,1.63
SVK,lsfoINDUSTRY_price,2001,2016,15,3.9000001
SVK,natgasINDUSTRY_price,1978,2016,38,2.22
SVN,dieselHOUSEHOLDS_atp,2005,2016,11,-3.8299999
SVN,dieselINDUSTRY_atpri,2005,2016,11,-3.8299999
SVN,electrHOUSEHOLDS_atp,2008,2016,8,-2.49
SVN,electrINDUSTRY_atpri,2008,2016,8,-8.3000002
SVN,lfoHOUSEHOLDS_atpric,2005,2016,11,-3.95
SVN,lfoINDUSTRY_atprice,2005,2016,11,-3.95
SVN,lpgHOUSEHOLDS_atpric,2005,2016,11,-2.51
SVN,lpgINDUSTRY_atprice,2005,2016,11,-2.51
SVN,lsfoINDUSTRY_atprice,2005,2016,11,-.56
SVN,natgasHOUSEHOLDS_atp,2008,2016,8,-6.9099998
SVN,natgasINDUSTRY_atpri,2008,2016,8,-8.6199999
SVN,unprem95HOUSEHOLDS_a,2005,2016,11,-2.3699999
SVN,unprem98HOUSEHOLDS_a,2008,2016,8,-6.6799998
SVN,dieselHOUSEHOLDS_pri,2005,2016,11,-1.29
SVN,electrHOUSEHOLDS_pri,2008,2016,8,-.75
SVN,lfoHOUSEHOLDS_price,2005,2016,11,-.46000001
SVN,lpgHOUSEHOLDS_price,2005,2016,11,-1.83
SVN,natgasHOUSEHOLDS_pri,2008,2016,8,-5.6500001
SVN,unprem95HOUSEHOLDS_p,2005,2016,11,-.41
SVN,unprem98HOUSEHOLDS_p,2008,2016,8,-3.0799999
SVN,dieselINDUSTRY_price,2005,2016,11,-1.4400001
SVN,electrINDUSTRY_price,2008,2016,8,-6.6399999
SVN,lfoINDUSTRY_price,2005,2016,11,-.61000001
SVN,lpgINDUSTRY_price,2005,2016,11,-1.98
SVN,lsfoINDUSTRY_price,2005,2016,11,.38999999
SVN,natgasINDUSTRY_price,2008,2016,8,-8.1300001
SWE,bitcoalHOUSEHOLDS_at,1978,1989,11,-2.0899999
SWE,bitcoalINDUSTRY_atpr,1978,1991,13,-5.8400002
SWE,cokcoalINDUSTRY_atpr,1978,1989,11,-5.3600001
SWE,dieselHOUSEHOLDS_atp,1978,2016,38,.82999998
SWE,dieselINDUSTRY_atpri,1978,2016,38,.82999998
SWE,electrHOUSEHOLDS_atp,1978,2016,38,-.25999999
SWE,electrINDUSTRY_atpri,1978,2016,38,-.5
SWE,hsfoINDUSTRY_atprice,1978,1984,6,6.6500001
SWE,leadpremHOUSEHOLDS_a,1978,2000,22,-1.6799999
SWE,lfoHOUSEHOLDS_atpric,1978,2013,35,3.1400001
SWE,lfoINDUSTRY_atprice,1978,2016,38,.090000004
SWE,lsfoINDUSTRY_atprice,1985,2016,31,-.69999999
SWE,natgasHOUSEHOLDS_atp,2007,2016,9,-2.1600001
SWE,natgasINDUSTRY_atpri,2007,2016,9,-5.8499999
SWE,unprem95HOUSEHOLDS_a,1993,2016,23,.61000001
SWE,unprem98HOUSEHOLDS_a,1993,2016,23,.52999997
SWE,bitcoalHOUSEHOLDS_pr,1978,1989,11,.88
SWE,dieselHOUSEHOLDS_pri,1978,2016,38,3.1099999
SWE,electrHOUSEHOLDS_pri,1978,2016,38,.62
SWE,leadpremHOUSEHOLDS_p,1978,2000,22,.81
SWE,lfoHOUSEHOLDS_price,1978,2013,35,4.8400002
SWE,natgasHOUSEHOLDS_pri,2007,2016,9,-1.42
SWE,unprem95HOUSEHOLDS_p,1993,2016,23,0
SWE,unprem98HOUSEHOLDS_p,1993,2016,23,.11
SWE,bitcoalINDUSTRY_pric,1978,1991,13,-1.7
SWE,cokcoalINDUSTRY_pric,1978,1989,11,-5.75
SWE,dieselINDUSTRY_price,1978,2016,38,2.51
SWE,electrINDUSTRY_price,1978,2016,38,-.91000003
SWE,hsfoINDUSTRY_price,1978,1984,6,9.1800003
SWE,lfoINDUSTRY_price,1978,2016,38,1.47
SWE,lsfoINDUSTRY_price,1985,2016,31,1.51
SWE,natgasINDUSTRY_price,2007,2016,9,-4.6199999
THA,dieselINDUSTRY_atpri,1997,2002,5,.82999998
THA,lfoHOUSEHOLDS_atpric,1990,2002,12,.89999998
THA,unprem95HOUSEHOLDS_a,1997,2002,5,1.23
THA,unregHOUSEHOLDS_atpr,1997,2002,5,.46000001
THA,electrHOUSEHOLDS_pri,1978,2010,32,-.52999997
THA,leadpremHOUSEHOLDS_p,1978,1998,20,-2.5799999
THA,leadregHOUSEHOLDS_pr,1978,2000,22,-1.5599999
THA,lfoHOUSEHOLDS_price,1978,2010,32,3.78
THA,lpgHOUSEHOLDS_price,2000,2010,10,5.5999999
THA,unprem95HOUSEHOLDS_p,1992,2010,18,5.2399998
THA,unregHOUSEHOLDS_pric,1997,2010,13,7.8800001
THA,bitcoalINDUSTRY_pric,1978,2010,32,-4.5100002
THA,dieselINDUSTRY_price,1978,2010,32,2.96
THA,electrINDUSTRY_price,1978,2010,32,-1.13
THA,hsfoINDUSTRY_price,1978,2010,32,3.8099999
THA,lsfoINDUSTRY_price,1998,2010,12,11.21
THA,natgasINDUSTRY_price,1998,2010,12,9.9700003
TUR,bitcoalHOUSEHOLDS_at,1992,2016,24,.44999999
TUR,bitcoalINDUSTRY_atpr,1992,2016,24,-.51999998
TUR,cokcoalINDUSTRY_atpr,1992,2016,24,3.0999999
TUR,dieselHOUSEHOLDS_atp,1995,2016,21,3.96
TUR,dieselINDUSTRY_atpri,1988,2016,28,3.97
TUR,electrHOUSEHOLDS_atp,1978,2016,38,-1.49
TUR,electrINDUSTRY_atpri,1978,2016,38,-1.74
TUR,hsfoINDUSTRY_atprice,1988,2016,28,7.2199998
TUR,leadpremHOUSEHOLDS_a,1988,2005,17,8.6300001
TUR,lfoHOUSEHOLDS_atpric,1988,2016,28,3.8599999
TUR,lpgHOUSEHOLDS_atpric,2007,2016,9,-2.8399999
TUR,lpgINDUSTRY_atprice,2002,2016,14,1.6900001
TUR,natgasHOUSEHOLDS_atp,1988,2016,28,-.15000001
TUR,natgasINDUSTRY_atpri,1988,2016,28,.55000001
TUR,unprem95HOUSEHOLDS_a,1991,2016,25,-.33000001
TUR,bitcoalHOUSEHOLDS_pr,1980,2016,36,.94
TUR,dieselHOUSEHOLDS_pri,1995,2016,21,3.5899999
TUR,electrHOUSEHOLDS_pri,1978,2016,38,-1.42
TUR,leadpremHOUSEHOLDS_p,1978,2005,27,2
TUR,lfoHOUSEHOLDS_price,1978,2016,38,1.24
TUR,lpgHOUSEHOLDS_price,2007,2016,9,-3.8299999
TUR,natgasHOUSEHOLDS_pri,1988,2016,28,.25999999
TUR,unprem95HOUSEHOLDS_p,1991,2016,25,.5
TUR,bitcoalINDUSTRY_pric,1979,2016,37,-1.99
TUR,cokcoalINDUSTRY_pric,1978,2016,38,-.30000001
TUR,dieselINDUSTRY_price,1978,2016,38,1.63
TUR,electrINDUSTRY_price,1978,2016,38,-1.42
TUR,hsfoINDUSTRY_price,1978,2016,38,.50999999
TUR,lpgINDUSTRY_price,2002,2016,14,1.1900001
TUR,natgasINDUSTRY_price,1988,2016,28,1.0700001
TWN,bitcoalINDUSTRY_atpr,1978,2000,22,-1.01
TWN,dieselHOUSEHOLDS_atp,1978,2011,33,44.52
TWN,dieselINDUSTRY_atpri,1978,2011,33,2
TWN,electrHOUSEHOLDS_atp,1978,2010,32,.19
TWN,electrINDUSTRY_atpri,1978,2010,32,.60000002
TWN,hsfoINDUSTRY_atprice,1978,2008,30,2.95
TWN,leadpremHOUSEHOLDS_a,1980,1999,19,-6.6900001
TWN,lfoINDUSTRY_atprice,1980,2011,31,.68000001
TWN,lpgHOUSEHOLDS_atpric,2001,2011,10,10.84
TWN,lpgINDUSTRY_atprice,2001,2011,10,7.9299998
TWN,lsfoINDUSTRY_atprice,1994,2011,17,7.1999998
TWN,natgasHOUSEHOLDS_atp,1980,2011,31,.079999998
TWN,natgasINDUSTRY_atpri,1978,2011,33,3.3199999
TWN,unprem95HOUSEHOLDS_a,1990,2011,21,.07
TWN,unprem98HOUSEHOLDS_a,2000,2011,11,5.1599998
TWN,unregHOUSEHOLDS_atpr,1982,2011,29,-1.46
TWN,dieselHOUSEHOLDS_pri,1978,2011,33,2.6300001
TWN,electrHOUSEHOLDS_pri,1978,2010,32,.34
TWN,leadpremHOUSEHOLDS_p,1978,1999,21,-1.98
TWN,lpgHOUSEHOLDS_price,2001,2011,10,10.42
TWN,natgasHOUSEHOLDS_pri,1980,2011,31,.18000001
TWN,unprem95HOUSEHOLDS_p,1990,2011,21,.14
TWN,unprem98HOUSEHOLDS_p,2000,2011,11,3.3800001
TWN,unregHOUSEHOLDS_pric,1982,2011,29,-.88
TWN,bitcoalINDUSTRY_pric,1978,2000,22,-.79000002
TWN,dieselINDUSTRY_price,1978,2011,33,2.6300001
TWN,electrINDUSTRY_price,1978,2010,32,.75
TWN,hsfoINDUSTRY_price,1978,2008,30,3.1500001
TWN,lfoINDUSTRY_price,1980,2011,31,.75999999
TWN,lpgINDUSTRY_price,2001,2011,10,7.5799999
TWN,lsfoINDUSTRY_price,1994,2011,17,7.0700002
TWN,natgasINDUSTRY_price,1978,2011,33,3.47
USA,dieselHOUSEHOLDS_atp,1978,2016,38,1.01
USA,dieselINDUSTRY_atpri,1992,2016,24,1.77
USA,hsfoINDUSTRY_atprice,1999,2016,17,3.4400001
USA,lfoHOUSEHOLDS_atpric,2002,2016,14,2.6500001
USA,lfoINDUSTRY_atprice,2002,2016,14,2.24
USA,unprem95HOUSEHOLDS_a,1994,2016,22,1.9400001
USA,unprem98HOUSEHOLDS_a,1983,2016,33,-.23999999
USA,unregHOUSEHOLDS_atpr,1978,2016,38,.0099999998
USA,dieselHOUSEHOLDS_pri,1978,2016,38,.97000003
USA,electrHOUSEHOLDS_pri,1978,2016,38,-.050000001
USA,leadregHOUSEHOLDS_pr,1978,1990,12,.31
USA,lfoHOUSEHOLDS_price,1978,2016,38,1.05
USA,natgasHOUSEHOLDS_pri,1978,2016,38,.74000001
USA,unprem95HOUSEHOLDS_p,1994,2016,22,1.33
USA,unprem98HOUSEHOLDS_p,1983,2016,33,-.28
USA,unregHOUSEHOLDS_pric,1978,2016,38,.20999999
USA,bitcoalINDUSTRY_pric,1978,2016,38,-.86000001
USA,cokcoalINDUSTRY_pric,1978,2016,38,.51999998
USA,dieselINDUSTRY_price,1992,2016,24,1.17
USA,electrINDUSTRY_price,1978,2016,38,-.52999997
USA,hsfoINDUSTRY_price,1978,2016,38,.44
USA,lfoINDUSTRY_price,1978,2016,38,.25999999
USA,natgasINDUSTRY_price,1978,2016,38,-.94999999
VEN,dieselINDUSTRY_atpri,1981,1999,18,7.1300001
VEN,leadpremHOUSEHOLDS_a,1981,1999,18,-3.25
VEN,leadregHOUSEHOLDS_at,1981,1996,15,1.9299999
VEN,lfoINDUSTRY_atprice,1981,1999,18,8.1099997
VEN,electrHOUSEHOLDS_pri,1981,1999,18,-2.8499999
VEN,leadpremHOUSEHOLDS_p,1981,1999,18,-.11
VEN,leadregHOUSEHOLDS_pr,1981,1996,15,3.2
VEN,natgasHOUSEHOLDS_pri,1981,2000,19,.12
VEN,bitcoalINDUSTRY_pric,1994,1999,5,-2.79
VEN,dieselINDUSTRY_price,1981,1999,18,8.1800003
VEN,electrINDUSTRY_price,1981,1999,18,1.97
VEN,lfoINDUSTRY_price,1981,1999,18,8.2399998
VEN,natgasINDUSTRY_price,1981,2000,19,-6.8499999
ZAF,dieselINDUSTRY_atpri,1988,2010,22,3.6700001
ZAF,leadpremHOUSEHOLDS_a,1987,2010,23,3.29
ZAF,leadregHOUSEHOLDS_at,1987,2010,23,4.0100002
ZAF,unprem95HOUSEHOLDS_a,1997,2010,13,6.6300001
ZAF,bitcoalHOUSEHOLDS_pr,1990,2005,15,0
ZAF,electrHOUSEHOLDS_pri,1978,2006,28,-2.1900001
ZAF,leadpremHOUSEHOLDS_p,1978,2010,32,.88
ZAF,leadregHOUSEHOLDS_pr,1978,2010,32,.94
ZAF,unprem95HOUSEHOLDS_p,1997,2010,13,4.77
ZAF,bitcoalINDUSTRY_pric,1990,2005,15,-.79000002
ZAF,dieselINDUSTRY_price,1978,2010,32,.69999999
ZAF,electrINDUSTRY_price,1978,2006,28,-3.0699999
ZAF,hsfoINDUSTRY_price,1982,2007,25,.16
ZAF,natgasINDUSTRY_price,1978,2005,27,1.55
